###############################
#p     ** *  1 *   *  * * *   #
# ### #*#*# #*#*# # # #*#*#*# #
#   *     ***  *      *   * * #
# ### * # #*# # #*#*# # # # #*#
#            **  *  *        *#
# # ##### * * # * #*###*### # #
#*  *      *  *      *     ** #
# # # # #*# # # #*#*####*## # #
#*    **  *       *      **   #
# #*# ### # # # #*# # # # # # #
#           *   *  *         x#
###############################